63
45
53 53 53 53 53 53 53 53 53 53 53 53 53 53 53 53 53 53 53 53 53 53 53 53 53 53 53 53 53 53 53 53 53 53 53 53 53 53 53 53 53 53 53 53 53 53 53 53 53 53 53 53 53 53 53 53 53 53 53 53 53 53 53 
53 53 53 53 53 53 53 53 53 53 53 53 53 53 53 53 53 53 53 53 53 53 53 53 53 53 53 53 53 53 53 53 53 53 53 53 53 53 53 53 53 53 53 53 53 53 53 53 53 53 53 53 53 53 53 53 53 53 53 53 53 53 53 
53 53 53 53 53 53 53 53 53 53 53 53 53 53 53 53 53 53 53 53 53 53 53 53 53 53 53 53 53 53 53 53 53 53 53 53 53 53 53 53 53 53 53 53 53 53 53 53 53 53 53 53 53 53 53 53 53 53 53 53 53 53 53 
53 53 53 53 53 53 53 53 53 53 53 53 53 53 53 53 53 53 53 53 53 53 53 53 53 53 53 53 53 53 53 53 53 53 53 53 53 53 53 53 53 53 53 53 53 53 53 53 53 53 53 53 53 53 53 53 53 53 53 53 53 53 53 
53 53 53 53 53 53 53 53 53 53 53 53 53 53 53 53 53 53 53 53 53 53 53 53 53 53 53 53 53 53 53 53 53 53 53 53 53 53 53 53 53 53 53 53 53 53 53 53 53 53 53 53 53 53 53 53 53 53 53 53 53 53 53 
53 53 53 53 53 53 53 53 53 53 53 53 53 53 53 53 53 53 53 53 53 53 53 53 53 53 53 53 53 53 53 53 53 53 53 53 53 53 53 53 53 53 53 53 53 53 53 53 53 53 53 53 53 53 53 53 53 53 53 53 53 53 53 
53 53 53 53 53 53 53 53 53 53 53 53 53 53 53 53 53 53 53 53 53 53 53 53 53 53 53 53 53 53 53 53 53 53 53 53 53 53 53 53 53 53 53 53 53 53 53 53 53 53 53 53 53 53 53 53 53 53 53 53 53 53 53 
53 53 53 53 53 53 53 53 53 53 53 53 53 53 53 24 24 24 24 24 24 24 24 24 24 24 24 24 24 24 24 24 24 24 24 24 24 24 24 24 24 24 24 24 24 24 24 24 24 53 53 53 53 53 53 53 53 53 53 53 53 53 53 
53 53 53 53 53 53 53 53 53 53 53 53 53 53 53 51 51 51 51 51 51 51 51 51 51 51 51 51 51 51 51 51 20 20 51 51 51 51 51 51 51 51 51 51 51 51 51 51 51 53 53 53 53 53 53 53 53 53 53 53 53 53 53 
53 53 53 53 53 53 53 53 53 53 53 53 53 53 53 52 48 48 48 52 52 48 48 52 52 52 52 52 52 48 48 48 47 47 52 48 48 52 52 52 52 52 21 21 52 52 52 48 48 53 53 53 53 53 53 53 53 53 53 53 53 53 53 
53 53 53 53 53 53 53 53 53 53 53 53 53 53 53 52 48 48 21 47 47 47 47 47 47 47 47 47 47 48 47 47 47 47 47 47 21 47 47 47 47 47 47 47 47 47 47 47 48 53 53 53 53 53 53 53 53 53 53 53 53 53 53 
53 53 53 53 53 53 53 53 53 53 53 53 53 53 53 52 48 48 47 47 47 47 47 47 47 21 21 47 47 47 47 47 47 47 47 47 47 47 47 47 47 47 47 47 47 47 47 47 47 53 53 53 53 53 53 53 53 53 53 53 53 53 53 
53 53 53 53 53 53 53 53 53 53 53 53 53 53 53 52 47 48 47 47 47 47 47 47 47 47 47 47 47 47 47 47 47 47 47 47 47 47 21 21 47 47 48 48 47 47 47 47 47 53 53 53 53 53 53 53 53 53 53 53 53 53 53 
53 53 53 53 53 53 53 53 53 53 53 53 53 53 53 52 47 47 47 47 47 47 47 48 48 48 47 47 47 47 47 21 21 47 47 47 47 47 21 21 47 48 48 48 47 47 47 47 47 53 53 53 53 53 53 53 53 53 53 53 53 53 53 
53 53 53 53 53 53 53 53 53 53 15 18 18 18 18 18 18 18 18 18 18 18 18 18 18 18 18 18 18 18 18 18 18 18 18 18 18 18 18 18 18 18 18 18 18 18 18 18 18 18 18 18 46 53 53 53 53 53 53 53 53 53 53 
53 53 53 53 53 53 53 53 53 53 16 19 19 19 19 19 19 19 19 19 20 19 19 19 19 19 19 19 19 19 20 19 19 19 19 19 19 19 19 19 19 19 19 19 19 20 19 19 19 19 19 19 45 53 53 53 53 53 53 53 53 53 53 
53 53 53 53 53 53 53 53 53 53 17 4 4 4 4 2 4 4 4 4 4 4 2 3 4 4 4 2 4 4 4 4 4 4 4 4 2 3 4 4 4 2 4 4 4 4 4 4 2 3 4 4 44 53 53 53 53 53 53 53 53 53 53 
53 53 53 53 53 53 53 53 53 53 2 1 1 1 1 2 2 2 2 2 2 2 2 5 1 1 1 2 2 2 2 2 2 2 2 2 2 5 1 1 1 2 2 2 2 2 2 2 2 5 1 1 43 53 53 53 53 53 53 53 53 53 53 
53 53 53 53 53 53 53 53 53 53 2 1 1 1 1 4 4 4 4 4 4 4 4 41 1 1 1 4 4 4 4 4 4 4 4 4 4 41 1 1 1 4 4 4 4 4 4 4 4 41 1 1 1 53 53 53 53 53 53 53 53 53 53 
53 53 53 53 53 53 53 53 53 53 2 1 1 1 1 1 1 1 6 7 8 1 1 1 1 1 1 1 1 1 1 1 1 1 1 1 1 1 1 1 1 1 1 1 6 7 8 1 1 1 1 1 1 53 53 53 53 53 53 53 53 53 53 
53 53 53 53 53 53 53 53 53 53 2 1 1 1 1 1 1 1 9 10 11 1 1 1 39 1 1 1 1 1 1 1 1 1 1 1 1 1 1 39 1 1 1 1 9 10 11 1 1 1 1 1 1 53 53 53 53 53 53 53 53 53 53 
53 53 53 53 53 53 53 53 53 53 2 1 1 1 30 31 32 1 12 13 14 31 32 27 38 2 1 1 1 1 1 1 1 1 1 1 1 1 1 38 27 31 32 1 12 13 14 1 1 1 31 32 29 53 53 53 53 53 53 53 53 53 53 
53 53 53 53 53 53 53 53 53 53 2 1 29 39 29 33 34 5 1 1 1 33 34 28 38 2 2 2 2 2 2 2 2 2 2 2 2 2 2 38 30 33 34 5 1 1 1 1 1 1 33 34 28 53 53 53 53 53 53 53 53 53 53 
53 53 53 53 53 53 53 53 53 53 2 1 27 38 2 30 29 41 1 1 1 28 27 41 38 2 4 4 4 4 4 4 4 4 4 4 4 4 4 38 2 27 30 41 1 1 1 1 1 1 28 29 41 53 53 53 53 53 53 53 53 53 53 
53 53 53 53 53 53 53 53 53 53 18 18 18 40 18 18 18 18 35 36 18 18 18 18 40 18 18 18 18 18 18 18 18 18 18 18 18 18 18 40 18 18 18 18 18 35 36 18 18 18 18 18 18 53 53 53 53 53 53 53 53 53 53 
53 53 53 53 53 53 53 53 53 53 37 37 37 37 37 37 37 37 35 36 37 37 37 37 37 37 37 37 37 37 37 37 37 37 37 37 37 37 37 37 37 37 37 37 37 35 36 37 37 37 37 37 37 53 53 53 53 53 53 53 53 53 53 
53 53 53 53 53 53 53 53 53 53 19 19 19 19 19 19 19 19 35 36 19 19 19 25 26 19 19 19 19 19 19 19 19 19 19 19 19 19 19 25 26 19 19 19 19 35 36 19 19 19 19 19 19 53 53 53 53 53 53 53 53 53 53 
53 53 53 53 53 53 53 53 53 53 2 29 28 4 4 4 4 4 41 1 4 4 4 33 34 3 4 4 2 3 4 4 4 4 4 2 3 4 4 33 34 3 4 4 4 41 1 4 4 4 28 27 4 53 53 53 53 53 53 53 53 53 53 
53 53 53 53 53 53 53 53 53 53 28 31 32 29 1 1 1 1 1 1 1 1 1 30 28 41 1 30 2 5 1 1 1 1 1 2 27 1 1 28 27 41 1 1 1 1 1 1 1 27 31 32 28 53 53 53 53 53 53 53 53 53 53 
53 53 53 53 53 53 53 53 53 53 29 33 34 28 1 1 1 1 1 1 1 1 1 1 1 1 1 28 2 5 1 1 1 1 1 2 28 1 1 1 1 1 1 1 1 1 1 1 1 28 33 34 27 53 53 53 53 53 53 53 53 53 53 
53 53 53 53 53 53 53 53 53 53 2 28 29 41 1 1 1 1 1 1 1 1 1 1 1 1 1 28 2 5 1 1 1 1 1 2 28 1 1 1 1 1 1 1 1 1 1 1 1 1 27 28 41 53 53 53 53 53 53 53 53 53 53 
53 53 53 53 53 53 53 53 53 53 2 1 1 1 1 1 1 1 1 1 1 1 1 1 1 1 1 30 2 5 1 1 1 1 1 2 27 1 1 1 1 1 1 1 1 1 1 1 1 1 1 1 1 53 53 53 53 53 53 53 53 53 53 
53 53 53 53 53 53 53 53 53 53 2 1 1 1 1 1 1 1 1 1 1 1 1 1 1 1 1 1 4 4 4 4 4 4 4 4 41 1 1 1 1 1 1 1 1 1 1 1 1 1 1 1 1 53 53 53 53 53 53 53 53 53 53 
53 53 53 53 53 53 53 53 53 53 2 1 1 1 1 1 1 1 1 1 1 1 1 1 1 1 1 1 1 1 1 1 1 1 1 1 1 1 1 1 1 1 1 1 1 1 1 1 1 1 1 1 1 53 53 53 53 53 53 53 53 53 53 
53 53 53 53 53 53 53 53 53 53 2 27 29 1 1 1 1 1 30 27 1 1 1 1 1 1 1 1 1 1 1 1 1 1 1 1 1 1 1 1 1 1 1 30 29 1 1 1 1 1 30 28 1 53 53 53 53 53 53 53 53 53 53 
53 53 53 53 53 53 53 53 53 53 29 31 32 27 1 1 1 27 31 32 30 1 1 1 1 1 1 1 1 1 1 1 1 1 1 1 1 1 1 1 1 1 29 31 32 30 1 1 1 28 31 32 30 53 53 53 53 53 53 53 53 53 53 
53 53 53 53 53 53 53 53 53 53 27 33 34 29 1 1 1 30 33 34 27 1 1 1 1 1 1 1 1 1 1 1 1 1 1 1 1 1 1 1 1 1 30 33 34 29 1 1 1 30 33 34 28 53 53 53 53 53 53 53 53 53 53 
53 53 53 53 53 53 53 53 53 53 2 29 27 41 1 1 1 1 27 30 41 1 1 1 1 1 1 1 1 1 1 1 1 1 1 1 1 1 1 1 1 1 1 29 30 41 1 1 1 1 28 30 41 53 53 53 53 53 53 53 53 53 53 
53 53 53 53 53 53 53 53 53 53 53 53 53 53 53 53 53 53 53 53 53 53 53 53 53 53 53 53 53 53 53 53 53 53 53 53 53 53 53 53 53 53 53 53 53 53 53 53 53 53 53 53 53 53 53 53 53 53 53 53 53 53 53 
53 53 53 53 53 53 53 53 53 53 53 53 53 53 53 53 53 53 53 53 53 53 53 53 53 53 53 53 53 53 53 53 53 53 53 53 53 53 53 53 53 53 53 53 53 53 53 53 53 53 53 53 53 53 53 53 53 53 53 53 53 53 53 
53 53 53 53 53 53 53 53 53 53 53 53 53 53 53 53 53 53 53 53 53 53 53 53 53 53 53 53 53 53 53 53 53 53 53 53 53 53 53 53 53 53 53 53 53 53 53 53 53 53 53 53 53 53 53 53 53 53 53 53 53 53 53 
53 53 53 53 53 53 53 53 53 53 53 53 53 53 53 53 53 53 53 53 53 53 53 53 53 53 53 53 53 53 53 53 53 53 53 53 53 53 53 53 53 53 53 53 53 53 53 53 53 53 53 53 53 53 53 53 53 53 53 53 53 53 53 
53 53 53 53 53 53 53 53 53 53 53 53 53 53 53 53 53 53 53 53 53 53 53 53 53 53 53 53 53 53 53 53 53 53 53 53 53 53 53 53 53 53 53 53 53 53 53 53 53 53 53 53 53 53 53 53 53 53 53 53 53 53 53 
53 53 53 53 53 53 53 53 53 53 53 53 53 53 53 53 53 53 53 53 53 53 53 53 53 53 53 53 53 53 53 53 53 53 53 53 53 53 53 53 53 53 53 53 53 53 53 53 53 53 53 53 53 53 53 53 53 53 53 53 53 53 53 
53 53 53 53 53 53 53 53 53 53 53 53 53 53 53 53 53 53 53 53 53 53 53 53 53 53 53 53 53 53 53 53 53 53 53 53 53 53 53 53 53 53 53 53 53 53 53 53 53 53 53 53 53 53 53 53 53 53 53 53 53 53 53 
