65
47
22 22 22 22 22 22 22 22 22 22 22 22 22 22 22 22 22 22 22 22 22 22 22 22 22 22 22 22 22 22 22 22 22 22 22 22 22 22 22 22 22 22 22 22 22 22 22 22 22 22 22 22 22 22 22 22 22 22 22 22 22 22 22 22 22 
22 22 22 22 22 22 22 22 22 22 22 22 22 22 22 22 22 22 22 22 22 22 22 22 22 22 22 22 22 22 22 22 22 22 22 22 22 22 22 22 22 22 22 22 22 22 22 22 22 22 22 22 22 22 22 22 22 22 22 22 22 22 22 22 22 
22 22 22 22 22 22 22 22 22 22 22 22 22 22 22 22 22 22 22 22 22 22 22 22 22 22 22 22 22 22 22 22 22 22 22 22 22 22 22 22 22 22 22 22 22 22 22 22 22 22 22 22 22 22 22 22 22 22 22 22 22 22 22 22 22 
22 22 22 22 22 22 22 22 22 22 22 22 22 22 22 22 22 22 22 22 22 22 22 22 22 22 22 22 22 22 22 22 22 22 22 22 22 22 22 22 22 22 22 22 22 22 22 22 22 22 22 22 22 22 22 22 22 22 22 22 22 22 22 22 22 
22 22 22 22 22 22 22 22 22 22 22 22 22 22 22 22 22 22 22 22 22 22 22 22 22 22 22 22 22 22 22 22 22 22 22 22 22 22 22 22 22 22 22 22 22 22 22 22 22 22 22 22 22 22 22 22 22 22 22 22 22 22 22 22 22 
22 22 22 22 22 22 22 22 22 22 22 22 22 22 22 22 22 22 22 22 22 22 22 22 22 22 22 22 22 22 22 22 22 22 22 22 22 22 22 22 22 22 22 22 22 22 22 22 22 22 22 22 22 22 22 22 22 22 22 22 22 22 22 22 22 
22 22 22 22 22 22 22 22 22 22 25 25 25 25 25 25 25 25 25 25 25 25 25 25 25 25 25 25 25 25 25 25 25 25 25 25 25 25 25 25 25 25 25 25 25 25 25 25 25 25 25 25 25 25 25 22 22 22 22 22 22 22 22 22 22 
22 22 22 22 22 22 22 22 22 23 1 1 1 1 1 1 1 1 1 1 4 4 1 1 1 1 1 1 1 1 1 1 1 1 1 1 1 1 1 1 1 1 1 1 1 1 1 1 1 1 1 1 1 1 1 21 22 22 22 22 22 22 22 22 22 
22 22 22 22 22 22 22 22 22 23 1 1 1 4 4 2 1 1 1 2 4 4 4 1 1 1 2 2 1 1 1 3 3 1 1 1 1 1 1 1 1 1 1 1 3 1 1 1 1 1 1 1 1 1 1 21 22 22 22 22 22 22 22 22 22 
22 22 22 22 22 22 22 22 22 23 1 1 1 2 1 1 4 1 4 1 1 1 1 2 1 1 2 1 4 1 4 1 4 1 1 1 1 1 1 3 1 1 1 1 1 1 1 1 1 3 1 1 1 1 1 21 22 22 22 22 22 22 22 22 22 
22 22 22 22 22 22 22 22 22 23 1 1 1 2 1 3 4 3 1 2 1 1 2 1 1 4 4 1 1 2 1 1 4 1 1 1 1 1 1 1 1 1 4 1 1 1 3 3 3 1 1 3 1 1 1 21 22 22 22 22 22 22 22 22 22 
22 22 22 22 22 22 22 22 22 23 1 1 1 2 3 4 1 1 1 4 2 4 1 1 1 1 2 1 1 1 1 1 3 1 1 1 1 1 1 1 1 1 1 1 1 1 1 1 3 1 1 3 1 1 1 21 22 22 22 22 22 22 22 22 22 
22 22 22 22 22 22 22 22 22 23 1 1 4 2 2 4 4 4 4 4 4 4 4 4 4 4 1 1 1 1 1 1 1 1 1 1 1 1 1 1 1 1 1 1 4 1 1 1 1 1 1 1 1 1 1 21 22 22 22 22 22 22 22 22 22 
22 22 22 22 22 22 22 22 22 23 1 4 1 1 1 3 4 4 1 1 1 1 12 8 13 1 4 3 4 1 4 2 2 4 1 3 2 4 1 1 1 1 1 1 1 4 1 1 1 1 1 1 1 1 1 21 22 22 22 22 22 22 22 22 22 
22 22 22 22 22 22 22 22 22 23 1 4 4 1 4 4 1 1 1 1 1 1 6 5 7 1 2 1 1 3 3 1 1 1 1 1 1 2 1 12 8 8 8 8 8 8 8 8 8 8 8 13 1 1 1 21 22 22 22 22 22 22 22 22 22 
22 22 22 22 22 22 22 22 22 23 1 1 4 1 4 1 3 1 1 1 1 1 6 5 7 1 3 118 1 1 1 1 1 1 1 123 1 3 1 6 5 5 5 5 5 5 5 5 5 5 5 7 1 1 1 21 22 22 22 22 22 22 22 22 22 
22 22 22 22 22 22 22 22 22 23 1 1 4 1 4 1 1 3 1 1 1 1 6 5 7 1 4 117 1 1 1 3 3 1 1 122 1 2 1 6 5 14 9 9 9 9 9 9 9 9 9 11 1 1 1 21 22 22 22 22 22 22 22 22 22 
22 22 22 22 22 22 22 22 22 23 1 1 4 1 4 1 1 3 3 1 1 1 6 5 7 1 1 117 3 3 1 1 1 1 1 122 1 3 1 6 5 7 1 4 1 3 1 1 1 1 1 1 1 1 1 21 22 22 22 22 22 22 22 22 22 
22 22 22 22 22 22 22 22 22 23 1 1 4 1 4 1 1 1 1 3 3 3 6 5 7 1 1 117 1 1 1 1 1 1 1 122 1 3 1 6 5 7 4 1 1 3 1 1 1 1 1 1 1 1 1 21 22 22 22 22 22 22 22 22 22 
22 22 22 22 22 22 22 22 22 23 1 1 4 1 4 1 1 1 1 1 1 1 6 5 7 3 3 117 1 1 2 2 1 1 1 122 1 4 1 6 5 7 4 1 1 1 1 1 1 1 1 1 1 1 1 21 22 22 22 22 22 22 22 22 22 
22 22 22 22 22 22 22 22 22 23 1 115 115 115 115 115 115 115 115 115 3 3 6 5 7 1 4 117 1 1 1 3 1 1 1 122 1 1 1 6 5 7 1 1 3 1 1 1 1 1 1 1 1 1 1 21 22 22 22 22 22 22 22 22 22 
22 22 22 22 22 22 22 22 22 23 1 115 115 115 115 115 115 115 115 115 3 1 6 5 7 1 1 117 1 1 1 1 1 1 1 122 1 4 1 6 5 7 1 1 1 1 1 1 1 1 1 1 1 1 1 21 22 22 22 22 22 22 22 22 22 
22 22 22 22 22 22 22 22 22 23 1 115 115 115 115 115 115 115 115 115 1 1 6 5 7 1 1 116 1 1 1 1 1 4 1 121 1 1 1 6 5 7 1 1 1 1 1 1 1 4 1 1 1 1 1 21 22 22 22 22 22 22 22 22 22 
22 22 22 22 22 22 22 22 22 23 1 115 115 115 115 115 115 115 115 115 1 1 6 5 16 8 8 8 8 8 8 8 8 8 8 8 8 8 8 17 5 7 3 3 1 1 1 1 1 4 1 1 1 1 1 21 22 22 22 22 22 22 22 22 22 
22 22 22 22 22 22 22 22 22 23 1 4 4 1 1 35 3 32 1 3 1 1 6 5 5 5 5 5 5 5 5 5 5 5 5 5 5 5 5 5 5 7 1 1 1 3 4 4 4 4 1 1 1 1 1 21 22 22 22 22 22 22 22 22 22 
22 22 22 22 22 22 22 22 22 23 3 4 1 1 1 34 3 31 4 4 1 3 6 5 14 9 9 9 9 9 9 9 9 9 9 9 9 9 9 15 5 7 1 1 4 4 1 1 1 1 1 1 1 1 1 21 22 22 22 22 22 22 22 22 22 
22 22 22 22 22 22 22 22 22 23 3 4 1 1 1 33 28 30 1 3 3 1 6 5 7 2 2 2 2 2 2 2 2 2 2 2 2 1 1 6 5 16 8 8 8 8 8 8 8 8 8 8 13 1 1 21 22 22 22 22 22 22 22 22 22 
22 22 22 22 22 22 22 22 22 23 3 1 1 1 3 3 3 3 3 3 1 1 6 5 7 2 2 2 18 19 19 19 19 19 20 4 115 115 1 6 5 5 5 5 5 5 5 5 5 5 5 5 7 1 1 21 22 22 22 22 22 22 22 22 22 
22 22 22 22 22 22 22 22 22 23 1 3 1 1 1 4 1 1 1 3 1 1 6 5 7 2 4 2 21 22 22 22 22 22 23 2 115 115 1 6 5 14 9 9 9 9 9 9 9 9 9 9 11 1 1 21 22 22 22 22 22 22 22 22 22 
22 22 22 22 22 22 22 22 22 23 1 3 3 1 1 1 1 1 3 1 1 1 6 5 7 2 2 2 21 22 22 22 22 22 23 2 115 115 1 6 5 7 1 1 1 1 1 1 1 1 1 1 1 1 1 21 22 22 22 22 22 22 22 22 22 
22 22 22 22 22 22 22 22 22 23 1 1 3 3 3 4 3 3 3 1 4 4 6 5 7 2 3 2 21 22 22 22 22 22 23 2 115 115 1 6 5 7 1 1 4 4 4 4 4 4 1 1 1 1 1 21 22 22 22 22 22 22 22 22 22 
22 22 22 22 22 22 22 22 22 23 1 1 1 3 3 4 3 3 3 4 1 1 6 5 7 2 2 2 21 22 22 22 22 22 23 2 115 115 1 6 5 7 1 1 1 1 1 4 4 4 1 1 1 1 1 21 22 22 22 22 22 22 22 22 22 
22 22 22 22 22 22 22 22 22 23 1 1 1 3 1 4 1 4 4 3 1 1 6 5 7 2 3 2 21 22 22 22 22 22 23 2 115 115 1 6 5 7 4 1 1 1 1 1 4 4 4 4 1 1 1 21 22 22 22 22 22 22 22 22 22 
22 22 22 22 22 22 22 22 22 23 1 1 1 3 1 4 4 4 3 3 3 1 6 5 7 2 3 2 24 22 22 22 22 22 26 2 115 115 1 6 5 7 4 1 1 27 28 28 28 29 1 1 1 1 1 21 22 22 22 22 22 22 22 22 22 
22 22 22 22 22 22 22 22 22 23 1 1 1 3 1 4 4 1 1 3 3 3 6 5 7 4 2 2 2 24 22 22 22 26 2 2 115 115 1 6 5 7 4 1 1 1 1 1 4 4 1 4 1 1 1 21 22 22 22 22 22 22 22 22 22 
22 22 22 22 22 22 22 22 22 23 1 1 1 3 1 4 1 1 1 1 3 1 6 5 7 2 2 2 2 2 21 22 23 2 2 2 4 2 1 6 5 7 1 1 115 115 115 115 115 115 115 115 115 1 1 21 22 22 22 22 22 22 22 22 22 
22 22 22 22 22 22 22 22 22 23 1 12 8 8 8 8 8 8 8 8 8 8 17 5 16 8 8 8 13 2 21 22 23 2 12 8 8 8 8 17 5 7 1 4 115 115 115 115 115 115 115 115 115 1 1 21 22 22 22 22 22 22 22 22 22 
22 22 22 22 22 22 22 22 22 23 1 6 5 5 5 5 5 5 5 5 5 5 5 5 5 5 5 5 7 2 21 22 23 2 6 5 5 5 5 5 5 7 1 1 115 115 115 115 115 115 115 115 115 1 1 21 22 22 22 22 22 22 22 22 22 
22 22 22 22 22 22 22 22 22 23 1 10 9 9 9 9 9 9 9 9 9 9 9 9 9 9 9 9 11 2 21 22 23 2 10 9 9 9 9 9 9 11 1 1 115 115 115 115 115 115 115 115 115 1 1 21 22 22 22 22 22 22 22 22 22 
22 22 22 22 22 22 22 22 22 23 1 1 1 1 1 1 1 1 1 1 1 1 1 1 1 2 2 2 2 2 21 22 23 2 2 2 2 2 2 2 2 1 1 1 1 1 1 1 1 1 1 1 1 1 1 21 22 22 22 22 22 22 22 22 22 
22 22 22 22 22 22 22 22 22 22 19 19 19 19 19 19 19 19 19 19 19 19 19 19 19 19 19 19 19 19 22 22 22 19 19 19 19 19 19 19 19 19 19 19 19 19 19 19 19 19 19 19 19 19 19 22 22 22 22 22 22 22 22 22 22 
22 22 22 22 22 22 22 22 22 22 22 22 22 22 22 22 22 22 22 22 22 22 22 22 22 22 22 22 22 22 22 22 22 22 22 22 22 22 22 22 22 22 22 22 22 22 22 22 22 22 22 22 22 22 22 22 22 22 22 22 22 22 22 22 22 
22 22 22 22 22 22 22 22 22 22 22 22 22 22 22 22 22 22 22 22 22 22 22 22 22 22 22 22 22 22 22 22 22 22 22 22 22 22 22 22 22 22 22 22 22 22 22 22 22 22 22 22 22 22 22 22 22 22 22 22 22 22 22 22 22 
22 22 22 22 22 22 22 22 22 22 22 22 22 22 22 22 22 22 22 22 22 22 22 22 22 22 22 22 22 22 22 22 22 22 22 22 22 22 22 22 22 22 22 22 22 22 22 22 22 22 22 22 22 22 22 22 22 22 22 22 22 22 22 22 22 
22 22 22 22 22 22 22 22 22 22 22 22 22 22 22 22 22 22 22 22 22 22 22 22 22 22 22 22 22 22 22 22 22 22 22 22 22 22 22 22 22 22 22 22 22 22 22 22 22 22 22 22 22 22 22 22 22 22 22 22 22 22 22 22 22 
22 22 22 22 22 22 22 22 22 22 22 22 22 22 22 22 22 22 22 22 22 22 22 22 22 22 22 22 22 22 22 22 22 22 22 22 22 22 22 22 22 22 22 22 22 22 22 22 22 22 22 22 22 22 22 22 22 22 22 22 22 22 22 22 22 
22 22 22 22 22 22 22 22 22 22 22 22 22 22 22 22 22 22 22 22 22 22 22 22 22 22 22 22 22 22 22 22 22 22 22 22 22 22 22 22 22 22 22 22 22 22 22 22 22 22 22 22 22 22 22 22 22 22 22 22 22 22 22 22 22 
